00111111111111111111111111111111111111111
00000000001000001000101000001000100010001
10111011101110101010101010111011111010111
10100010000010100010100010000010000010101
11101111111010101011111011111010101010101
10000000001000101000101000100000101000001
11111011111110101110101010111110101111101
10101000000010101000100010100000100010001
10101110111111101110111111111110111011111
10001010101010101000001010001000100010001
11101010101010111011111010101011111010101
10000010101000000000100000101010000010101
11101111101011111110111010111011111010101
10000000000000100000001010101010100010101
11111110111010111110111011101110111010101
10001000001010001000000000001010000010101
11101111101011101011111111111011101011101
10000000001010001000001000100010001000001
11111111111011111011101011111011111110101
10100000100000101000100010000010001000101
10111110111111101111101011101110111011101
10101000001000000000101000001010000010101
10101011111111111110111110111011111010111
10000000000010000010000000000000000010001
11101110111011111010111111101110101111101
10100010100000000010001010100010100000001
10111011101011111111111010101010111111101
10001000101000100000101010001010100010101
10111011111110111011101010111010111010101
10100000000010000010100000100010001000001
10101110111011101010111011111011101011101
10000010100010101010000000001010001010001
10101010101110101110101010111111111110101
10101010100000101000101010000010000000101
11111011101011101010111010111111111011101
10001000101010000010101010001000101010101
10111111111111101111101110111110101110101
10000000100000101000000000000000001010001
10111110101010101110101111101110101010111
1000100000101000001010000010001010001000
1111111111111111111111111111111111111110
